1111111
1000C01
10C0001
1000001
1111111