1111111111111111111111111111111111
1000000000000000000000000000000001
1000111110000000000000000000000001
10010CCC010000000000000111000000C1
10100CCC00111111111111100011000C01
101000000000000000000000000010C001
1001EPCCCCCCCCCCCCCCCCCCCCCCCCC0C1
101000000000000000000000000010C001
10100CCC00111111111111100011000C01
10010CCC010000000000000111000000C1
1000111110000000000000000000000001
1000000000000000000000000000000001
1111111111111111111111111111111111