1111111111111111111111111
10000000000000000000000E1
101001001110000110C110001
1011110001000111111111101
1010C10001C00001111110001
1010010011100000011000001
1P00000000000000000000001
1111111111111111111111111