11111111111111
10C00010000P01
100000E0000001
10000010000001
11111111111111
