1111111111111111111111111111111
1E1111111111111C11111C111111111
1111111111111111111111111111111
1111111111111111111111111111111
1P1111111C11C1111111111111111C1
1111111111111111111111111111111
