111111111111111111111111111111111
1E0000000000000C00000C00000000000
101001010010000010100100000010101
101001001010101000100100000010101
1P0000000C00C000000000000000000C1
111111111111111111111111111111111
